jeabernathy@ufl.edu	James	E	Abernathy
r.afzal@ufl.edu	Rimza		Afzal
jagarth@ufl.edu	Joshua	D	Agarth
allisonaguirre@ufl.edu	Allison	M	Aguirre
aalmond@ufl.edu	Austin	D	Almond
galnadi@ufl.edu	Ghaith	N	Alnadi
raloni@ufl.edu	Raz	M	Aloni
banderson3@ufl.edu	Bailey	R	Anderson
corya14@ufl.edu	Cory	S	Anderson
sarusmagnificus@ufl.edu	Sarah	A	Anderson
sand3rs0n@ufl.edu	Steven	D	Anderson
jeanralphaviles@ufl.edu	Jean-Ralph		Aviles
ben.babtsov@ufl.edu	Benjamin		Babtsov
marcus.ball@ufl.edu	Marcus	A	Ball
barahonaraul@ufl.edu	Raul	E	Barahona
jjbarta@ufl.edu	John	J	Barta
kbarta@ufl.edu	Kevin	Joesph	Barta
josephbateh@ufl.edu	Joseph	Charles	Bateh
tessbianchi@ufl.edu	Tess	H	Bianchi
evanbishop@ufl.edu	Evan	W	Bishop
rlb1116@ufl.edu	Ryan	L	Blanchard
jbocinsky@ufl.edu	James	M	Bocinsky
sahir24@ufl.edu	Sahir		Boghani
pbohana@ufl.edu	Paige	A	Bohana
klborowski@ufl.edu	Kelli	L	Borowski
sbosi@ufl.edu	Sergio		Bosi
somedag@ufl.edu	Tyler	J	Bower
matthewbregg610@ufl.edu	Matthew	J	Bregg
jcalderaio@ufl.edu	John	Anthony	Calderaio
mcalvo0776@ufl.edu	Matthew	J	Calvo
dcampbell82@ufl.edu	David	M	Campbell
bcarberry@ufl.edu	Benjamin	Hugh Doston	Carberry
lt.carbonell@ufl.edu	Luis	T	Carbonell
lcardoso@ufl.edu	Lisbeth		Cardoso
jacksonecarroll@ufl.edu	Jackson	E	Carroll
wcase@ufl.edu	William	C	Case
salimc@ufl.edu	Salim		Chaouqi
heyguysbbq@ufl.edu	Jesse	K	Chau
benchen@ufl.edu	Benjamin	C	Chen
jiaueichen@ufl.edu	Jia-Uei		Chen
jennifer.cheung@ufl.edu	Jennifer		Cheung
cchierico@ufl.edu	Christine	M	Chierico
nchouvalis95@ufl.edu	Nikos	A	Chouvalis
echristiansen@ufl.edu	Erik	H	Christiansen
nc10nchu@ufl.edu	Naweeya		Chutiraka
ncioli@ufl.edu	Nicholas		Cioli
acodella1953@ufl.edu	Anthony	R	Codella
alexcoleman@ufl.edu	Alexander	J	Coleman
camcooper@ufl.edu	Cameron		Cooper
andrealcosta@ufl.edu	Andrea	L	Costa
ncritelli1@ufl.edu	Nicholas	T	Critelli
jonc205@ufl.edu	Jonathan	W	Cruz
scruz2294@ufl.edu	Stephanie	A	Cruz
mcudic@ufl.edu	Mihael		Cudic
geodude626@ufl.edu	Giovanni		De La Torre
rdemaio1@ufl.edu	Robert	R	Demaio
gabadiaz@ufl.edu	Gabriel	A	Diaz
ndiez@ufl.edu	Nicholas	D	Diez
btdillon@ufl.edu	Brian	T	Dillon
luluding@ufl.edu	Qianwen		Ding
nick50@ufl.edu	Nicholas	R	Dingler
ndirocco@ufl.edu	Nickolas	P	Dirocco
bdiuguid@ufl.edu	Stephen	Benjamin	Diuguid
crisd0000@ufl.edu	Cristian		Duica
dmaximus@ufl.edu	Max	J	Dunevitz
celkin@ufl.edu	Connor	A	Elkin
n.elsishans@ufl.edu	Nathan	B	Elsishans
pemami@ufl.edu	Patrick	O	Emami
michael.everette@ufl.edu	Michael	D	Everette
evorapa@ufl.edu	Parker	J	Evora
exterkamps@ufl.edu	Shane	T	Exterkamp
ofaruque@ufl.edu	Omar		Faruque
marisagfernandez@ufl.edu	Marisa	G	Fernandez
mfernandez33@ufl.edu	Miguel	Armando	Fernandez
fidlkm@ufl.edu	Kristopher	M	Fidler
bfieldson@ufl.edu	Brian	M	Fieldson
kjfitzgerald@ufl.edu	Keith	James	Fitzgerald
lflood@ufl.edu	Leena	A	Flood
mbfrehafer@ufl.edu	Melany	B	Frehafer
bfricker@ufl.edu	Blake	A	Fricker
friedmangreg37@ufl.edu	Greg		Friedman
nicolascoding@ufl.edu	Nicolas	J	Fry
mvg991@ufl.edu	Ma	Vanessa M	Gabuya
egauzens@ufl.edu	Eric	J	Gauzens
reidgill12@ufl.edu	Reid	A	Gill
antonygillette@ufl.edu	Antony	L	Gillette
tgittelmacher@ufl.edu	Troy	E	Gittelmacher
ngoldfarb@ufl.edu	Nikita	G	Goldfarb
bgonzalez0429@ufl.edu	Brandon	R	Gonzalez
mgriessler@ufl.edu	Matthew	D	Griessler
drak@ufl.edu	Jeffery	A	Grosso
taviog@ufl.edu	Tavio	J	Guarino
sabrina.gisselle@ufl.edu	Sabrina	G	Gutierrez
bhamilton975@ufl.edu	Brian	P	Hamilton
bhammack@ufl.edu	Benjamin	A	Hammack
pharduvel@ufl.edu	Peter	A	Harduvel
johnrharrison@ufl.edu	John	Randolph	Harrison
mnhassan@ufl.edu	Mohamed	Nakibul	Hassan
cphazen@ufl.edu	Courtney	Paige	Hazen
xinhe@ufl.edu	Xin		He
ryan604@ufl.edu	Ryan	W	Henry
shernandez33@ufl.edu	Sebastian	S	Hernandez
scivy17@ufl.edu	Kevin	L	Hertlein
cheuser@ufl.edu	Callie	M	Heuser
shanhix1@ufl.edu	Shannon	M	Hicks
morganliam@ufl.edu	Morgan	L	Hodges
dholloway95@ufl.edu	Daniel	L	Holloway
bholton93@ufl.edu	Brandon	J	Holton
sholtzman@ufl.edu	Shaun	H	Holtzman
j1010101010@ufl.edu	Jason	R	Hsu
alexhu@ufl.edu	Alex		Hu
dhua20@ufl.edu	Derek	C	Hua
caelum@ufl.edu	Wyndham	C	Hudson
gdespointes@ufl.edu	Guilain	M	Huyghues-Despointes
tigic@ufl.edu	Tijana		Igic
nimamshah@ufl.edu	Nicholas	M	Imamshah
irwincollin@ufl.edu	Collin	H	Irwin
iiwasaki@ufl.edu	Ishin		Iwasaki
camj@ufl.edu	Cameron		Jeffords
juandi007@ufl.edu	Juan	D	Jimenez
andygjb@ufl.edu	Andy		John Baptiste
jjohnston94@ufl.edu	Jeremy	A	Johnston
jonesguy14@ufl.edu	Joachim	C	Jones
kegljl1@ufl.edu	Joshua	L	Kegley
bkelly2014@ufl.edu	Brian	P	Kelly
egk818@ufl.edu	Edward	G	Kelly
jackpkenn@ufl.edu	Jack	P	Kennedy
andrewjkerr47@ufl.edu	Andrew	J	Kerr
fkhandadia@ufl.edu	Farina		Khandadia
joshkirstein@ufl.edu	Joshua	B	Kirstein
hbkisshauer@ufl.edu	H	Blake	Kisshauer
skit13@ufl.edu	Seth	D	Kittles
megan0529@ufl.edu	Megan	L	Knight
jkovacs@ufl.edu	Jenna	A	Kovacs
lexkreh@ufl.edu	Alexandra	L	Krehbiel
mkroeze@ufl.edu	Matthew	I	Kroeze
nkroft@ufl.edu	Nicholas		Kroft
cfkwok@ufl.edu	Chun	F	Kwok
mattlangford95@ufl.edu	Matthew	A	Langford
damian.larson@ufl.edu	Damian	L	Larson
matt204@ufl.edu	Matthew	J	Laws
joseph.liccini@ufl.edu	Joseph	R	Liccini
slichtenheld@ufl.edu	Samuel	G	Lichtenheld
kylelin47@ufl.edu	Kyle		Lin
abc123456@ufl.edu	Ling		Lin
klind13@ufl.edu	Keenan	B	Lind
wlindquist@ufl.edu	Wyatt	B	Lindquist
scottliu@ufl.edu	Scott	E	Liu
jakeman893@ufl.edu	Paul	J	Logas
charlelotfalla@ufl.edu	Charle	H	Lotfalla
richard.lowrey@ufl.edu	Richard	A	Lowrey
dluppino@ufl.edu	Domenic	J	Luppino
elynch93@ufl.edu	Ethan	J	Lynch
justinmacedo@ufl.edu	Justin	V	Macedo
machadofl@ufl.edu	Anthony	C	Machado
toosday@ufl.edu	Emily	T	Macon
bmaldonado@ufl.edu	Breanna	N	Maldonado
kmarin@ufl.edu	Kevin	M	Marin
maroney.tm@ufl.edu	Tomas	P	Maroney
amarquez1@ufl.edu	Aaron	M	Marquez
jgmarsar@ufl.edu	Jeffrey	G	Marsar
caseyannmartin@ufl.edu	Casey	A	Martin
cormacpayne@ufl.edu	Cormac	P	Mccarthy
kyle44@ufl.edu	Kyle	D	Mckissack
jmclemore368@ufl.edu	Jeffrey	M	Mclemore
mwmcneely@ufl.edu	Mark	W	Mcneely
julianrmendoza@ufl.edu	Julian	R	Mendoza
merckerrobert@ufl.edu	Robert	J	Mercker
bmeredith@ufl.edu	Benjamin	B	Meredith
mrdjmeyers@ufl.edu	Donald	W	Meyers
rmollway@ufl.edu	Reid	P	Mollway
emanmomot@ufl.edu	Emmanuel	Fryderyk	Momot
pinkyarmando@ufl.edu	Madeleine	L	Monfort
c1moore@ufl.edu	Calvin	M	Moore
arrowtime@ufl.edu	Christine	Marie	Moore
bmori007@ufl.edu	Brandon		Mori
samanthamorocz@ufl.edu	Samantha	M	Morocz
mattdmorris@ufl.edu	Matthew	D	Morris
muletmiles@ufl.edu	Miles	F	Mulet
munda01@ufl.edu	David	J	Munzer
pnaing@ufl.edu	Pye	W	Naing
snason@ufl.edu	Samuel	Ross	Nason
dpallstar07@ufl.edu	Joshua	David	Nassar
gianghnguyen@ufl.edu	Giang	H	Nguyen
shreyan@ufl.edu	Shreya		Nirmalan
ryannordman@ufl.edu	Ryan	Robert	Nordman
jnovick@ufl.edu	Joshua	D	Novick
robert.olsthoorn@ufl.edu	Robert		Olsthoorn
korwig95@ufl.edu	Kiel	J	Orwig
o.oz@ufl.edu	Or		Oz
konradpabjan@ufl.edu	Konrad	S	Pabjan
thomaspalmer1@ufl.edu	Thomas	L	Palmer
tpank@ufl.edu	Victoria		Pankewich
moneymaker0218@ufl.edu	Neel	H	Patel
kpaterson@ufl.edu	Kenneth	R	Paterson
snikrepmada@ufl.edu	Adam	H	Perkins
peach@ufl.edu	Brandon	Taylor	Peterson
vpirie@ufl.edu	Veronica	Karen	Pirie
epogash@ufl.edu	Eric	A	Pogash
cjpope@ufl.edu	Christopher	J	Pope
chris8790@ufl.edu	Christoph		Porwol
noahpresser@ufl.edu	Noah	C	Presser
rpringle3@ufl.edu	Robert	J	Pringle
spuleri@ufl.edu	Sergio	A	Puleri
qureshia@ufl.edu	Adeel		Qureshi
mrawson@ufl.edu	Mason	Robert	Rawson
bookworm42795@ufl.edu	Leslie	Y	Richardson
richterc88@ufl.edu	Corey	A	Richter
sk8rlane@ufl.edu	John	M	Ridgeway
phillipriley@ufl.edu	Phillip	R	Riley
aerobau@ufl.edu	Alexander	E	Robau
arod412@ufl.edu	Alexis		Rodriguez
david.4101@ufl.edu	David	J	Rollins
flyskyxi@ufl.edu	Xixi		Ruan
t.wagner@ufl.edu	Tim	Michael	Russell-Wagner
wrussotto@ufl.edu	William	J	Russotto
dsabogal@ufl.edu	Daniel		Sabogal
batin84@ufl.edu	Sebastian		Sabogal
carlosnico@ufl.edu	Carlos	N	Salinas
jayson.salkey@ufl.edu	Jayson	P	Salkey
salujajustin@ufl.edu	Justin	J	Saluja
jrsaren@ufl.edu	John	R	Saren
asass02@ufl.edu	Adam	C	Sass
csaunders17@ufl.edu	Chad	A	Saunders
gdscheele@ufl.edu	Gavin	D	Scheele
kaschmidt@ufl.edu	Kenneth	A	Schmidt
ben822s@ufl.edu	Benjamin	W	Schneider
zmschultz@ufl.edu	Zachary	M	Schultz
bschwaller33@ufl.edu	Benjamin	J	Schwaller
kscicc9@ufl.edu	Kristen		Scicchitano
zscott@ufl.edu	Zachary	M	Scott
meserwinowski@ufl.edu	Matthew	E	Serwinowski
nsessions@ufl.edu	Noah	A	Sessions
jeffreyshao@ufl.edu	Jeffrey		Shao
baseball028@ufl.edu	Bradley	Franklin	Shea
ericjshea@ufl.edu	Eric	J	Shea
eshqiponja@ufl.edu	Ervis		Shqiponja
crsileo@ufl.edu	Christina	R	Sileo
simonnea@ufl.edu	Audrey		Simonne
psluder0100@ufl.edu	Preston	B	Sluder
alexs10@ufl.edu	Alexander	J	Smith
bryce.sperling@ufl.edu	Bryce	H	Sperling
astainsby@ufl.edu	Aaron	R	Stainsby
jrs5269@ufl.edu	Jose	Raul	Suarez
shandysulen@ufl.edu	Shandy	J	Sulen
derya.tansel@ufl.edu	Derya	Z	Tansel
nt92@ufl.edu	Nikhil		Thota
jtolentino@ufl.edu	Julian	N	Tolentino
ttouchton@ufl.edu	Trevor	J	Touchton
maix101@ufl.edu	Mai	T	Tran
jtraub91@ufl.edu	Jason	S	Traub
bmtreuherz@ufl.edu	Bradley	M	Treuherz
jhtrinkler@ufl.edu	Jared	H	Trinkler
kenantt@ufl.edu	Kenan	Tarik	Tufekci
masonturner@ufl.edu	Mason	F	Turner
tuhlich@ufl.edu	Tyler	J	Uhlich
igorvakulenko@ufl.edu	Igor		Vakulenko
mvalois27@ufl.edu	Miquel	J	Valois-Velez
tvaseliou@ufl.edu	Thomas	S	Vaseliou
vnikhil@ufl.edu	Nikhil		Venkatesh
avera0513@ufl.edu	Angel	N	Vera
villejacob@ufl.edu	Jacob	L	Ville
dwells@ufl.edu	Daniel	J	Wells
rorath@ufl.edu	David	K	Weng
stevenjwilliams@ufl.edu	Steven	J	Williams
rwillsey@ufl.edu	Richard	G	Willsey
grwolfe@ufl.edu	Gregory	R	Wolfe
eawolfson@ufl.edu	Eric	A	Wolfson
dwood12@ufl.edu	Drew	T	Wood
azxdsw25@ufl.edu	Kevin		Wu
txie0@ufl.edu	Tonny		Xie
kenany@ufl.edu	Kenan	A	Yildirim
gziadi@ufl.edu	Gonzalo		Ziadi
jziggy@ufl.edu	James	W	Ziegenfelder
zobeldavid@ufl.edu	David		Zobel
